111111111
1E00C1001
101C000P1
1100010C1
111111111
