111111111
1E00C0001
100C000P1
1000000C1
111111111
