1111111111111
11111P0111111
1100110110111
1000000000001
1111111111111