1111111111111
11111P0111111
1100110110111
10000000000E1
1111111111111