1111111111111
1EC00C100C011
1001C001101C1
10100010C01P1
1111111111111