1111111111111
1EC00C100C011
1001C00011001
101C0010C01P1
1111111111111