111111111
1E10C00C1
1C1111101
1P00C00C1
111111111