1111111111
1C0010C001
1E10000011
11C1100101
11P00000C1
1111111111