111111111
10C00C001
1E1111101
1P00C00C1
111111111