111111111
1E100C001
111111101
1P00C00C1
111111111